abaixar - okuruxa.                                  
abandonar - ohiya, onyanyala.                       
abater preço - ovukula.                                 
abelha - nvu, mivu.                            
abóbora - marapo.                                
aborrecer - onanariha.                                
abraçar - ovara, okhuparela.                         
abreviar - okhuviha,wàkuveya.                    
abrir - otthukula,  okhunula, otaphula, ohula.                               
abster-se - winanela.                                 
abundar - wàtta, ohithovva, ohirère.               
acabar - omala, omaliha, olikanyiha, okhvva, okisa, ophera.                                   
acalentar - olola.                                   
acautelar-se - opasòpa, wipasòpa.                      
aceitar - wàkhela.                                 
acelerar - wàkuveya.                               
acertar - olikanyiha.                              
estar aceso - ovarela.                                  
achar - ophwanya, wòna, wupuwela.                              
ser ácido - onyunya.                               
aclamar - okhuwelela, otthapela.                   
açoitar - okuphula.                               
acolá - vale.                                    
acolher - wàkhela, wàkhelela.                  
acompanhar - orowana, ohòla, oroiha, otthara, ovelela.                       
aconselhar - olaka, ovaha miruku.                    
acontecer - wiraneya, okhumelela.                   
acorrer - otthimaka, otthimakela.                  
acostumado - olimalcla, okhovelela.                
acreditar - wàmini, okupali.                         
acrescentar - winjererya, wúnjererya.                   
acudir - wàkiha, wàkhula, wàkuvela.
acusar - ohimya.                                 
aderir - ophara.                                  
adeus! - khwahèri.                                
adiantar-se - ohòla. 
adivinhação - ehako.
adivinhar - wupuwela.
adivinho - nahako. 
causar admiração - otikiniha. 
ficar admirado - othamala, otikinihiwa.
admitir - wàkhulela.
admoestar - olakiherya, olaka, olopola. 
adoecer - owereiwa. 
adoptar - oleia.
adormecer - orupa. 
adular - wèpesa. 
cometer adultério - oraruvva. 
adulto - múlupale, àlupale.
adversário - mukhotto, nwanani.
afastar-se - othàma. 
afazeres - wèteteia miteko.
estar afiado - wètha, witha, onona.
afirmar - wàkhulela. 
aflição - oxanka.
afligir - ohàxa. 
aflito - ovelavela, ovela, oxanka, olava. 
afundar-se - onèla.
agarrar - ovara, ovarela.
agir mal - ottheka.
agora - nànàno, vano, nànàno va, vàva. 
agradar - osivela, osiveliha. 
agradecer - oxukhuru, otthapela, wàmini.
água - màsi. 
aguardar - owehererya, ororomela, olipelela, wàlitta. 
aguçado - othokolowa. 
agudo - othokolowa.
aguentar - owerya, ovilela.
aí - vo, vavo. 
ainda - nlelo, ninlelo, ohinatthi wira. 
ajudar - okhaliherya. 
ajustar - olikanyiha. 
alargar - wìnjererya, wúnjererya. 
alarido -  elulu.
alegrar-se - ottèliwa murima.                         
aleijado - orakala.                                 
além de - withela.                                 
fazer aliança - wàtàna.                                  
alimentar - olyiha.                                  
alimento - yòlya, sò.                               
alinhar - othata.                                 
amadurecer - ottokottha.                              
amaldiçoar - olava.                                   
amanhã - melo, màlo.
depois de amanhã - murotto.                                 
amanhecer - oxa.  
acordou bem?  - oxeleliwa.                 
amar - ophenta, otthuna.                        
amargo - onyunya, owawa.                         
amarra - mukhoi.                              
amarrar - otthuka, otthukela.                     
amassar - oruwa.                                   
ameaçar - olopola.                                
amendoim - mattuvi.          
amigo - mpatthani, mwàpara,  axa, nthamwene.          
amigos - axinthamene.    
amimar - wèpesa.                               
amizade - opatthani.               
fazer amizade - opatthana.
amo - pwiya, apvviya, mapwiya.            
amontoar - okweserya.                               
amparar - ovarela.                                 
ancião - humu, mahumu.                       
andar - wètta.                                   
animal - enama.
animal selvagem - enama ya mutakhwani, 
animal doméstico - enama ya vaté.
animal de criação - muhuwo.                             
anjo - nlaikha.                           
ano - eyakha.
próximo ano - mwahiyu. 
ano passado - mmwàisana.         
há dois anos - mmwàisuri.
este ano - mitano.                      
anoitecer - wila.                                    
anteontem - nsuri.                                    
antes de - ohinàtthi.
antigamente - khalai, khalayi.                        
anunciar - olaleya.                                 
aonde vai? - wòwi?, àvi?.                    
apagar - ottipiha, ottipha.                
apanhar do chão - ottotta.
apanhar com anzol - olowa.        
apanhar amendoim - omuthola mattuvi.                                 
aparecer - okhumelela.                              
apascentar - olyiha, ohuwa.                           
aperfeiçoar - orèriha.                           
apertar - ophara.                           
apetecer - osivela.                            
aplacar-se - okhurunuwa.                         
aplainar - opatta.                            
aplanar - wàtala.                          
apodrecer - wùntta.                           
aproximadamente - vakhiviru ni, ntoko. 
aproximar-se de - wàttamela.                                           
aquecer-se - wòra.           
aquela coisa - ele.
aquele - ole, ule, ele, nle, ale, iye.      
aqui - va, nno, vàva.                  
aquilo - ele.                              
ar - epheyo, iphumu.                    
arder - ovarela, olala, osòsa.
arma - eyuma, y’ekhotto.            
arrancar - ophela.                           
arranjar - olokiha.                           
arrear - okuruxa.                           
arrefecer - ovola.                            
arregaçar - okhuna.                          
arrepender-se - ottharuwa.                         
arroz - musoro, murama.
árvore - mwiri, miri.                  
asa - nipupha.                       
aspirar - ovura.                            
assar - wòxa.                              
assim - siso, sisa, so, vakhàni-vakhàni.                 
assistir doentes - oxekurya, othotola.             
assobiar - wòpa muturi.                      
assustar - otutuxa,  otuthuwa.
atar - otthuka.                           
até - mpakha.                      
atender - owiriyana, wiwelela.               
atirar - ovonya.                            
atormentar - ohàxa.                             
atraiçoar - wòtotha, othepya, owoka.           
atrás - ottuli.                            
atrasado - opisa.
atravessar - olapuwa. 
aturar - ovilela, oleva.                    
aumentar - wìnjererya, wúnjererya, wunnuwa, wimnuwiha, otepa.            
aurora - oxa.
ave - mwanúni,  axinuni,  mwapalame, axipalame. 
averiguar - wèttelela.                               
avisar - olopola.                            
avistar - wòna, oweha, onoweha.                         
azedo - onyunya.                             
azeite - makhura. 
baixo - okhuveya, wàpa.            
bambu - mulanje, muthale.                
banana - enika. 
bananeira - munika.                              
tomar banho - orapa.                                          
estar barato - okhweya.                                 
barba - ereru.                               
barro - etthaya, oloko, nthaka, nttaka.                           
fazer barulho - onyakula.                               
basta! - pàhi!. 
bastar - ophiyerya, omalela.                      
bater - omana, opwexa.                          
batuque - ekoma.                               
bêbado - namuhapaliwa, ananamuhapaliwa.                       
beber - owurya, ovurya.                          
bebida - otheka, yòwurya, sòyòwurya.                     
bem - orattène, sàna.           
estar bem - okhala.
estar bem feito - oratta.
bendizer - ottottopela.                            
bengala - ekopó.                                
bicar - othupa.                                  
bicho - munku, miyunku, axinku.             
boca - eyano, mwano.                         
bolo de arroz - mukatthe.                             
bolsa - murupa.                              
bom - òrèra murima, òrèra òloka, oratta, ankhili.              
bondade - òrèra murima.                            
bonito - òrèra.
borboleta - nikuruthu, manikuruthu.                           
bosque - etakhwa.                             
braço - mòno, miyòno.                       
bradar - okhuwa.                                  
branco - òttèla. 
bravo - owali.                                   
breve - okhuveya, wàkuweya.                      
brigar - owana                                   
brilhar - wàrya.                                   
brincar - orukuneya.                               
brotar - ophattuwa.
bruxaria - okhwiri.                                 
buscar - okuxa, orowela.              
cabaça - ekahi. 
cabeça - muru. 
cabelo - ekharari.
caber - okela. 
cabo de enxada - nvini, mivini. 
cabra - epuri, mwàpuri, axi.
cabrito - epuri, mwàpuri, axi. 
caçar - oxaya,  ototha, olupattha. 
cada - khula.
cadáver - murutthu.
cair - okurumuwa, omora. 
caju - ekhaju, ekoroso. 
cajueiro - mukhaju. 
calar - omàliha, omàla. 
cálice - ekahi.
calor - oviha. 
caluniar - wòtherya. 
cama - ekhittantta, olili. 
camaleão - namanriya, ana. 
caminhar - wètta. 
caminho - ephiro, okela ephiro. 
campo cultivado - ematta. 
campo não cultivado - mathala. 
candèiro - muthuko, examaniya.
cansado - okhulumuwa, ovela.
cansar-se - okhulumuwa, wòjeya.
cantar - wipa. 
canto - nsipo.
cão - mwalapwa, alapwa. 
capim - malaxi. 
capoeira - ehili. 
cara - witho, owitho,  ekhove.  
caril de carne - muhusi.
caril de   hortaliça - mathàpa.
carimbar - otthitta. 
carne - enama. 
carne de pessoa - ethayi. 
carneiro - epuri yòlopwana. 
caro - orika.
carregar num meio de transporte - opakhira.
carregar às  costas - oreya, othata. 
carro - ekàro. 
carta - epaphelo.  
carteira - murupa.
carvão - makhala, nikhala. 
casa - empa, enupa, mpàni.
casar - othela, otheliwa.                      
casca - ntakhuru.                       
castigar - ohukhumu.                               
catana - ekatana.                             
cauda - mwìla, mìla                            
causa - mulattu, mwaha.
por causa de - mwaha wa.                  
cavar - othola,  othipa,  olima.
cavar amendoim - omuthola.
cem - miloko mulokó.                                  
cemitério - mahiye, mmahiyeni.             
centro - eriyari.
cerca de - vakhiviru ni, ntoko.                    
certo - oloka.                                  
cesto de bambu - nivuku.
cesto - ethokwa.
céu - erimu.   
no céu - wirimu, osulu, musulu.                                 
chama - nlumi mana mòro.                    
chamar - wihana,  witthana, wihaniwa.                              
chão - vathí.                         
charco - ntthiya, nratta.                
chefe - muhòli, múlupale.
chefiar - ohòla.                                  
chega! - pàhi!.                                  
chegar - ophiya,  ophiyerya, opixa.                                  
cheio - osareya.                              
cheirar bem - wunkhela.
cheirar mal - wíinkha.
chorar - winla, wúnla.                           
chover - orupa epula, enòrupa epula.                         
chuva - epula.                               
cinco - thanu.                                  
cinquenta - emiya, miloko mithanu.                                
clã - nihimo, nloko.    
cobarde - wòlowa, wòva.                          
cobertura da casa em capim - nipatho.             
cobra - enowa.                               
cobrir - okhunela, wikhunela.              
coco - ekole, coqueiro, mukole.       
coelho - namarokolo, hukula.              
cogumelo - ovilu, othepu.                    
coisa - etthu, elexe, olexa.                            
colar - ophariha, onyomiherya.                  
colheita - ohepha, mulàla.                             
colher - ohatta, orukula, ohepha.                
colocar - ohela, opweha, wiyàthi.                
coluna - nripu, nipotto, muthana. 
com - ni.
começar - opajerya, okela, opaja. 
comer - olya, okhùra, orerya. 
comida - yòlya. 
como - ntoko.
compaixão - okhupanyerya,  othunikharari, ikharari.
companheiro - mukhwaaka, ekhwaaya, mwàpara, axàpara.                     
comparar - olikanyika.                          
competência - wàsa, etthu iyo  khinkàsa.  